# Tank Battle Map: Level 2 - River Crossing
# Size: 20x15
# Format: Each character represents a tile
# 0=Grass, 1=Brick, 2=Steel, 3=Water, 4=Forest, 5=Ice
# P=PlayerSpawn, E=EnemySpawn, U=PowerUpSpawn
#
11111111111111111111
1P000000000000000001
10000000000000000001
10000033333333333001
10000033333333333001
10000033333333333001
10000000000000000001
10000000000000000001
10000033333333333001
10000033333333333001
10000033333333333001
10000000000000000001
1000000000000000E001
1U000000000000000001
11111111111111111111