# Tank Battle Map: Level 3 - Maze
# Size: 20x15
# Format: Each character represents a tile
# 0=Grass, 1=Brick, 2=Steel, 3=Water, 4=Forest, 5=Ice
# P=PlayerSpawn, E=EnemySpawn, U=PowerUpSpawn
#
11111111111111111111
1P010101010101010101
10001000100010001001
10101010101010101001
10001000100010001001
10101010101010101001
10001000100010001001
10101010101010101001
10001000100010001001
10101010101010101001
10001000100010001001
10101010101010101001
1000100010001000E001
1U010101010101010101
11111111111111111111